{
  "map": [
    ["f", "f", "f", "f", "f", "f", "f", "f", "f", "f", "f", "f", "f", "f", "f", "f", "f", "f", "f", "f"],
    ["E", " ", " ", " ", " ", " ", " ", "f", "f", " ", " ", " ", " ", " ", " ", " ", " ", " ", " ", "f"],
    ["E", " ", " ", " ", " ", " ", " ", " ", "f", " ", " ", " ", " ", " ", " ", " ", " ", " ", " ", "f"],
    ["E", " ", " ", " ", " ", " ", " ", " ", "f", "f", " ", " ", " ", " ", " ", " ", " ", " ", " ", "f"],
    ["E", " ", " ", " ", " ", " ", " ", " ", " ", "f", " ", " ", " ", " ", " ", " ", " ", " ", " ", "f"],
    ["f", " ", " ", " ", " ", " ", " ", " ", " ", "f", "f", " ", " ", " ", " ", " ", " ", " ", " ", "f"],
    ["f", " ", " ", " ", " ", " ", " ", " ", " ", " ", "f", " ", " ", " ", " ", " ", " ", " ", " ", "f"],
    ["f", " ", " ", " ", " ", " ", " ", " ", " ", " ", "f", "f", " ", " ", " ", " ", " ", " ", " ", "f"],
    ["f", "f", " ", " ", " ", " ", " ", " ", " ", " ", " ", "f", "f", " ", " ", " ", " ", " ", " ", "f"],
    ["f", "f", " ", " ", " ", " ", " ", " ", " ", " ", " ", " ", "f", "f", "f", " ", " ", " ", " ", "f"],
    ["f", "f", "f", " ", " ", " ", " ", " ", " ", " ", " ", " ", " ", " ", "f", "f", "f", " ", " ", "f"],
    ["f", " ", "f", " ", " ", " ", " ", " ", " ", " ", " ", " ", " ", " ", " ", " ", "f", "f", "f", "f"],
    ["f", " ", "f", "f", " ", " ", " ", " ", " ", " ", " ", " ", " ", " ", " ", " ", " ", " ", " ", "f"],
    ["f", " ", " ", "f", " ", " ", " ", " ", " ", " ", " ", " ", " ", " ", " ", " ", " ", " ", " ", "f"],
    ["f", " ", " ", "f", "f", " ", " ", " ", " ", " ", " ", " ", " ", " ", " ", " ", " ", " ", " ", "f"],
    ["f", " ", " ", " ", "f", "f", " ", " ", " ", " ", " ", " ", " ", " ", " ", " ", " ", " ", " ", "e"],
    ["f", " ", " ", " ", " ", "f", "f", "f", " ", " ", " ", " ", " ", " ", " ", " ", " ", " ", " ", "e"],
    ["f", " ", " ", " ", " ", " ", " ", "f", "f", "f", " ", " ", " ", " ", " ", " ", " ", " ", " ", "e"],
    ["f", " ", " ", " ", " ", " ", " ", " ", " ", "f", "f", "f", " ", " ", " ", " ", " ", " ", " ", "e"],
    ["f", "f", "f", "f", "f", "f", "f", "f", "f", "f", "f", "f", "f", "f", "f", "f", "f", "f", "f", "f"]
  ],
  "entrance": [[0, 1], [1, 4]],
  "exit": [[19, 15], [1, 4]],
  "wind direction": "down",
  "no brakes": true
}