{
  "map": [
    ["f", "f", "f", "f", "f", "f", "f", "f", "f", "f", "f", "f", "f", "f", "f", "f", "f", "f", "f", "f"],
    ["f", " ", " ", " ", " ", " ", " ", " ", " ", " ", " ", " ", " ", " ", " ", " ", "f", "f", " ", "f"],
    ["f", " ", " ", " ", " ", " ", " ", " ", " ", " ", " ", " ", " ", " ", " ", " ", "f", " ", " ", "f"],
    ["f", " ", " ", " ", " ", " ", " ", " ", " ", " ", " ", " ", " ", " ", " ", " ", "f", " ", " ", "f"],
    ["f", " ", " ", " ", " ", " ", " ", " ", " ", " ", " ", " ", " ", " ", " ", " ", "f", " ", " ", "f"],
    ["f", " ", " ", " ", " ", " ", " ", " ", " ", "f", "f", " ", " ", " ", " ", " ", "f", " ", " ", "f"],
    ["f", " ", " ", " ", " ", " ", " ", " ", "f", "f", " ", " ", " ", " ", " ", "f", "f", " ", " ", "f"],
    ["f", " ", " ", " ", " ", " ", " ", " ", "f", " ", " ", " ", " ", " ", " ", "f", " ", " ", " ", "f"],
    ["f", " ", " ", " ", " ", " ", " ", "f", "f", " ", " ", " ", " ", " ", " ", "f", " ", " ", " ", "f"],
    ["f", " ", " ", " ", " ", " ", " ", "f", " ", " ", " ", " ", " ", " ", "f", "f", " ", " ", " ", "f"],
    ["f", " ", " ", " ", " ", " ", "f", "f", " ", " ", " ", " ", " ", " ", "f", " ", " ", " ", " ", "f"],
    ["f", " ", " ", " ", " ", " ", "f", " ", " ", " ", " ", " ", " ", "f", "f", " ", " ", " ", " ", "e"],
    ["f", " ", " ", " ", " ", " ", "f", " ", " ", " ", " ", " ", " ", "f", " ", " ", " ", " ", " ", "e"],
    ["f", " ", " ", " ", " ", "f", "f", " ", " ", " ", " ", " ", "f", "f", " ", " ", " ", " ", " ", "e"],
    ["f", " ", " ", " ", " ", "f", " ", " ", " ", " ", " ", "f", "f", " ", " ", " ", " ", " ", " ", "e"],
    ["f", " ", " ", " ", " ", "f", " ", " ", " ", " ", " ", " ", " ", " ", " ", " ", " ", " ", " ", "f"],
    ["f", " ", " ", " ", " ", "f", " ", " ", " ", " ", " ", " ", " ", " ", " ", " ", " ", " ", " ", "f"],
    ["f", " ", " ", " ", " ", "f", " ", " ", " ", " ", " ", " ", " ", " ", " ", " ", " ", " ", " ", "f"],
    ["f", " ", " ", " ", " ", "f", " ", " ", " ", " ", " ", " ", " ", " ", " ", " ", " ", " ", " ", "f"],
    ["f", "E", "E", "E", "E", "f", "f", "f", "f", "f", "f", "f", "f", "f", "f", "f", "f", "f", "f", "f"]
  ],
  "entrance": [[1, 19], [4, 1]],
  "exit": [[19, 11], [1, 4]],
  "wind direction": "right",
  "no brakes": true
}