{
  "map": [
    ["f", "f", "f", "f", "f", "f", "f", "f", "E", "E", "E", "E", "f", "f", "f", "f", "f", "f", "f", "f"],
    ["f", " ", " ", " ", " ", " ", " ", "f", " ", " ", " ", " ", "f", " ", " ", " ", " ", " ", " ", "f"],
    ["f", " ", " ", " ", " ", " ", " ", "f", " ", " ", " ", " ", "f", " ", " ", " ", " ", " ", " ", "f"],
    ["f", " ", " ", " ", " ", " ", " ", "f", " ", " ", " ", " ", "f", " ", " ", " ", " ", " ", " ", "f"],
    ["f", " ", " ", " ", " ", " ", " ", "f", " ", " ", " ", " ", "f", " ", " ", " ", " ", " ", " ", "f"],
    ["f", " ", " ", " ", "f", " ", " ", "f", " ", " ", " ", " ", "f", " ", " ", "f", " ", " ", " ", "f"],
    ["f", " ", " ", " ", "f", " ", " ", "f", " ", " ", " ", " ", "f", " ", " ", "f", " ", " ", " ", "f"],
    ["f", " ", " ", " ", "f", " ", " ", "f", " ", " ", " ", " ", "f", " ", " ", "f", " ", " ", " ", "f"],
    ["f", " ", " ", " ", "f", " ", " ", "f", " ", " ", " ", " ", "f", " ", " ", "f", " ", " ", " ", "f"],
    ["f", " ", " ", " ", "f", " ", " ", " ", " ", " ", " ", " ", " ", " ", " ", "f", " ", " ", " ", "f"],
    ["f", " ", " ", " ", "f", " ", " ", " ", " ", " ", " ", " ", " ", " ", " ", "f", " ", " ", " ", "f"],
    ["f", " ", " ", " ", "f", " ", " ", " ", " ", " ", " ", " ", " ", " ", " ", "f", " ", " ", " ", "f"],
    ["f", " ", " ", " ", "f", "f", "f", "f", "f", "f", "f", "f", "f", "f", "f", "f", " ", " ", " ", "f"],
    ["f", " ", " ", " ", "f", " ", " ", " ", " ", " ", " ", " ", " ", " ", " ", "f", " ", " ", " ", "f"],
    ["f", " ", " ", " ", "f", " ", " ", " ", " ", " ", " ", " ", " ", " ", " ", "f", " ", " ", " ", "f"],
    ["f", " ", " ", " ", "f", " ", " ", " ", " ", " ", " ", " ", " ", " ", " ", "f", " ", " ", " ", "f"],
    ["f", " ", " ", " ", " ", " ", " ", "f", " ", " ", " ", " ", "f", " ", " ", " ", " ", " ", " ", "f"],
    ["f", " ", " ", " ", " ", " ", " ", "f", " ", " ", " ", " ", "f", " ", " ", " ", " ", " ", " ", "f"],
    ["f", " ", " ", " ", " ", " ", " ", "f", " ", " ", " ", " ", "f", " ", " ", " ", " ", " ", " ", "f"],
    ["f", "f", "f", "f", "f", "f", "f", "f", "e", "e", "e", "e", "f", "f", "f", "f", "f", "f", "f", "f"]
  ],
  "entrance": [[8, 0], [4, 1]],
  "exit": [[8, 19], [4, 1]],
  "wind direction": "up",
  "no brakes": false
}