{
  "map": [
    ["f", "E", "E", "E", "E", "E", "f", "f", "f", "f", "f", "f", "f", "f", "f", "f", "f", "f", "f", "f"],
    ["f", " ", " ", " ", " ", " ", " ", " ", " ", " ", " ", " ", " ", " ", " ", " ", " ", " ", " ", "f"],
    ["f", " ", " ", " ", " ", " ", " ", " ", " ", " ", " ", " ", " ", " ", " ", " ", " ", " ", " ", "f"],
    ["f", " ", " ", " ", " ", " ", " ", " ", " ", " ", " ", " ", " ", " ", " ", " ", " ", " ", " ", "f"],
    ["f", " ", " ", " ", " ", " ", " ", " ", " ", " ", " ", " ", " ", " ", " ", " ", " ", " ", " ", "f"],
    ["f", " ", " ", " ", " ", " ", " ", " ", " ", " ", " ", " ", " ", " ", " ", " ", " ", " ", " ", "f"],
    ["f", "f", "f", "f", "f", "f", "f", "f", "f", "f", "f", "f", "f", "f", "f", " ", " ", " ", " ", "f"],
    ["f", "f", "f", "f", "f", "f", " ", " ", " ", " ", " ", " ", " ", " ", "f", " ", " ", " ", " ", "f"],
    ["f", "f", "f", "f", "f", "f", " ", " ", " ", " ", " ", " ", " ", " ", "f", " ", " ", " ", " ", "f"],
    ["f", "f", "f", "f", "f", "f", " ", " ", " ", " ", " ", " ", " ", " ", "f", " ", " ", " ", " ", "f"],
    ["f", "f", "f", "f", "f", "f", " ", " ", " ", " ", " ", " ", " ", " ", "f", " ", " ", " ", " ", "f"],
    ["f", "f", "f", "f", "f", "f", " ", " ", " ", " ", "f", " ", " ", " ", "f", " ", " ", " ", " ", "f"],
    ["f", "f", "f", "f", "f", "f", " ", " ", " ", " ", "f", " ", " ", " ", "f", " ", " ", " ", " ", "f"],
    ["f", "f", "f", "f", "f", "f", " ", " ", " ", " ", "f", " ", " ", " ", "f", " ", " ", " ", " ", "f"],
    ["f", "f", "f", "f", "f", "f", " ", " ", " ", " ", "f", " ", " ", " ", "f", " ", " ", " ", " ", "f"],
    ["e", " ", " ", " ", " ", " ", " ", " ", " ", " ", "f", " ", " ", " ", " ", " ", " ", " ", " ", "f"],
    ["e", " ", " ", " ", " ", " ", " ", " ", " ", " ", "f", " ", " ", " ", " ", " ", " ", " ", " ", "f"],
    ["e", " ", " ", " ", " ", " ", " ", " ", " ", " ", "f", " ", " ", " ", " ", " ", " ", " ", " ", "f"],
    ["e", " ", " ", " ", " ", " ", " ", " ", " ", " ", "f", " ", " ", " ", " ", " ", " ", " ", " ", "f"],
    ["f", "f", "f", "f", "f", "f", "f", "f", "f", "f", "f", "f", "f", "f", "f", "f", "f", "f", "f", "f"]
  ],
  "entrance": [[1, 0], [5, 1]],
  "exit": [[0, 15], [1, 4]],
  "wind direction": "nor here",
  "no brakes": false
}