{
  "map":  [
    ["f", "f", "f", "f", "f", "f", "f", "f", "f", "f", "f", "f", "f", "f", "f", "f", "f", "f", "f", "f"],
    ["f", " ", " ", " ", " ", " ", " ", " ", " ", " ", "f", " ", " ", " ", " ", " ", " ", " ", " ", "f"],
    ["f", " ", " ", " ", " ", " ", " ", " ", " ", " ", "f", " ", " ", " ", " ", " ", " ", " ", " ", "f"],
    ["f", " ", " ", " ", " ", " ", " ", " ", " ", " ", "f", " ", " ", " ", " ", " ", " ", " ", " ", "f"],
    ["f", " ", " ", " ", " ", " ", " ", " ", " ", " ", "f", " ", " ", " ", " ", "f", " ", " ", " ", "f"],
    ["f", " ", " ", " ", " ", "f", " ", " ", " ", " ", "f", " ", " ", " ", " ", "f", " ", " ", " ", "f"],
    ["f", " ", " ", " ", " ", "f", " ", " ", " ", " ", "f", " ", " ", " ", " ", "f", " ", " ", " ", "f"],
    ["f", " ", " ", " ", " ", "f", " ", " ", " ", " ", "f", " ", " ", " ", " ", "f", " ", " ", " ", "f"],
    ["f", " ", " ", " ", " ", "f", " ", " ", " ", " ", "f", " ", " ", " ", " ", "f", " ", " ", " ", "f"],
    ["f", " ", " ", " ", " ", "f", " ", " ", " ", " ", "f", " ", " ", " ", " ", "f", " ", " ", " ", "f"],
    ["f", " ", " ", " ", " ", "f", " ", " ", " ", " ", "f", " ", " ", " ", " ", "f", " ", " ", " ", "f"],
    ["f", " ", " ", " ", " ", "f", " ", " ", " ", " ", "f", " ", " ", " ", " ", "f", " ", " ", " ", "f"],
    ["f", " ", " ", " ", " ", "f", " ", " ", " ", " ", "f", " ", " ", " ", " ", "f", " ", " ", " ", "f"],
    ["E", " ", " ", " ", " ", "f", " ", " ", " ", " ", "f", " ", " ", " ", " ", "f", " ", " ", " ", "f"],
    ["E", " ", " ", " ", " ", "f", " ", " ", " ", " ", "f", " ", " ", " ", " ", "f", " ", " ", " ", "f"],
    ["E", " ", " ", " ", " ", "f", " ", " ", " ", " ", " ", " ", " ", " ", " ", "f", " ", " ", " ", "f"],
    ["E", " ", " ", " ", " ", "f", " ", " ", " ", " ", " ", " ", " ", " ", " ", "f", " ", " ", " ", "f"],
    ["f", " ", " ", " ", " ", "f", " ", " ", " ", " ", " ", " ", " ", " ", " ", "f", " ", " ", " ", "f"],
    ["f", " ", " ", " ", " ", "f", " ", " ", " ", " ", " ", " ", " ", " ", " ", "f", " ", " ", " ", "f"],
    ["f", "f", "f", "f", "f", "f", "f", "f", "f", "f", "f", "f", "f", "f", "f", "f", "e", "e", "e", "f"]
  ],
  "entrance": [[0, 13], [1, 4]],
  "exit": [[16, 19], [3, 1]],
  "wind direction": "left",
  "no brakes": true
}