{
  "map": [
    ["f", "e", "e", "f", "f", "f", "f", "f", "f", "f", "f", "f", "f", "f", "f", "f", "f", "f", "f", "f"],
    ["f", " ", " ", "f", " ", " ", " ", " ", " ", " ", " ", " ", " ", " ", "f", " ", " ", " ", " ", "f"],
    ["f", " ", " ", "f", " ", " ", " ", " ", " ", " ", " ", " ", " ", " ", "f", " ", " ", " ", " ", "f"],
    ["f", " ", " ", "f", " ", " ", "f", "f", "f", "f", " ", " ", "f", " ", " ", " ", "f", " ", " ", "f"],
    ["f", " ", " ", "f", " ", " ", " ", " ", " ", "f", " ", " ", "f", " ", " ", " ", "f", " ", " ", "f"],
    ["f", " ", " ", "f", " ", " ", " ", " ", " ", "f", " ", " ", "f", "f", "f", "f", "f", " ", " ", "f"],
    ["f", " ", " ", "f", " ", " ", " ", " ", " ", "f", " ", " ", " ", " ", " ", " ", "f", " ", " ", "f"],
    ["f", " ", " ", "f", " ", " ", " ", " ", " ", "f", " ", " ", " ", " ", " ", " ", "f", " ", " ", "f"],
    ["f", " ", " ", "f", " ", " ", "f", "f", "f", "f", " ", " ", "f", "f", "f", "f", "f", " ", " ", "f"],
    ["f", " ", " ", "f", " ", " ", "f", " ", " ", " ", " ", " ", " ", " ", " ", " ", "f", " ", " ", "f"],
    ["f", " ", " ", "f", " ", " ", "f", " ", " ", " ", " ", " ", " ", " ", " ", " ", "f", " ", " ", "f"],
    ["f", " ", " ", "f", " ", " ", "f", " ", " ", "f", " ", " ", "f", "f", "f", "f", "f", " ", " ", "f"],
    ["f", " ", " ", " ", " ", " ", "f", " ", " ", "f", " ", " ", "f", " ", " ", " ", " ", " ", " ", "f"],
    ["f", " ", " ", " ", " ", " ", "f", " ", " ", "f", " ", " ", "f", " ", " ", " ", " ", " ", " ", "f"],
    ["f", " ", " ", "f", "f", "f", "f", "f", "f", "f", " ", " ", "f", " ", " ", "f", "f", "f", "f", "f"],
    ["f", " ", " ", "f", "f", "f", "f", "f", "f", "f", " ", " ", "f", " ", " ", "f", " ", " ", " ", "E"],
    ["f", " ", " ", "f", "f", "f", "f", "f", "f", "f", " ", " ", "f", "f", "f", "f", " ", " ", " ", "E"],
    ["f", " ", " ", "f", "f", "f", "f", "f", "f", "f", " ", " ", " ", " ", " ", " ", " ", " ", " ", "E"],
    ["f", " ", " ", "f", "f", "f", "f", "f", "f", "f", " ", " ", " ", " ", " ", " ", " ", " ", " ", "E"],
    ["f", "f", "f", "f", "f", "f", "f", "f", "f", "f", "f", "f", "f", "f", "f", "f", "f", "f", "f", "f"]
  ],
  "entrance": [[19, 15], [1, 4]],
  "exit": [[1, 0], [2, 1]],
  "wind direction": "nor here",
  "no brakes": false
}