{
  "map": [
    ["f", "E", "E", "E", "f", "f", "f", "f", "f", "f", "e", "e", "e", "e", "f", "f", "f", "f", "f", "f"],
    ["f", " ", " ", " ", "f", "f", " ", " ", " ", " ", " ", " ", " ", " ", " ", " ", " ", " ", " ", "f"],
    ["f", " ", " ", " ", " ", "f", " ", " ", " ", " ", " ", " ", " ", " ", " ", " ", " ", " ", " ", "f"],
    ["f", " ", " ", " ", " ", "f", "f", " ", " ", " ", " ", " ", " ", " ", " ", " ", " ", " ", " ", "f"],
    ["f", " ", " ", " ", " ", " ", "f", " ", " ", " ", " ", " ", " ", " ", " ", " ", " ", " ", " ", "f"],
    ["f", " ", " ", " ", " ", " ", "f", "f", " ", " ", " ", " ", " ", " ", " ", " ", " ", " ", " ", "f"],
    ["f", " ", " ", " ", " ", " ", " ", "f", " ", " ", " ", " ", " ", " ", " ", " ", " ", " ", " ", "f"],
    ["f", " ", " ", " ", " ", " ", " ", "f", "f", " ", " ", " ", " ", " ", " ", " ", " ", " ", " ", "f"],
    ["f", " ", " ", " ", " ", " ", " ", " ", "f", " ", " ", " ", " ", " ", " ", " ", " ", " ", " ", "f"],
    ["f", " ", " ", " ", " ", " ", " ", " ", "f", "f", " ", " ", " ", " ", " ", " ", " ", " ", " ", "f"],
    ["f", " ", " ", " ", " ", " ", " ", " ", " ", "f", " ", " ", " ", " ", " ", " ", " ", " ", " ", "f"],
    ["f", " ", " ", " ", " ", " ", " ", " ", " ", "f", "f", " ", " ", " ", " ", " ", " ", " ", " ", "f"],
    ["f", " ", " ", " ", " ", " ", " ", " ", " ", " ", "f", " ", " ", " ", " ", " ", " ", " ", " ", "f"],
    ["f", " ", " ", " ", " ", " ", " ", " ", " ", " ", "f", "f", "f", "f", " ", " ", " ", " ", " ", "f"],
    ["f", " ", " ", " ", " ", " ", " ", " ", " ", " ", " ", " ", " ", " ", " ", " ", " ", " ", " ", "f"],
    ["f", " ", " ", " ", " ", " ", " ", " ", " ", " ", " ", " ", " ", " ", " ", " ", " ", " ", " ", "f"],
    ["f", " ", " ", " ", " ", " ", " ", " ", " ", " ", " ", " ", " ", " ", " ", " ", " ", " ", " ", "f"],
    ["f", " ", " ", " ", " ", " ", " ", " ", " ", " ", " ", " ", " ", " ", " ", " ", " ", " ", " ", "f"],
    ["f", " ", " ", " ", " ", " ", " ", " ", " ", " ", " ", " ", " ", " ", " ", " ", " ", " ", " ", "f"],
    ["f", "f", "f", "f", "f", "f", "f", "f", "f", "f", "f", "f", "f", "f", "f", "f", "f", "f", "f", "f"]
  ],
  "entrance": [[1, 0], [3, 1]],
  "exit": [[10, 0], [4, 1]],
  "wind direction": "down",
  "no brakes": true
}