{
  "map": [
    ["f", "f", "f", "f", "f", "f", "f", "f", "f", "f", "f", "f", "f", "f", "f", "f", "f", "f", "f", "f"],
    ["f", " ", " ", " ", " ", " ", " ", " ", " ", " ", "f", " ", " ", " ", " ", " ", " ", " ", " ", "f"],
    ["f", " ", " ", " ", " ", " ", " ", " ", " ", " ", "f", " ", " ", " ", " ", " ", " ", " ", " ", "f"],
    ["f", " ", " ", " ", " ", " ", " ", " ", " ", " ", "f", " ", " ", " ", " ", " ", " ", " ", " ", "f"],
    ["f", " ", " ", " ", " ", " ", " ", " ", " ", " ", "f", " ", " ", " ", " ", " ", " ", " ", " ", "f"],
    ["f", " ", " ", " ", " ", " ", " ", " ", " ", " ", "f", " ", " ", " ", " ", " ", " ", " ", " ", "f"],
    ["f", " ", " ", " ", " ", "f", " ", " ", " ", " ", "f", " ", " ", " ", "f", " ", " ", " ", " ", "f"],
    ["f", " ", " ", " ", " ", "f", " ", " ", " ", " ", "f", " ", " ", " ", "f", " ", " ", " ", " ", "f"],
    ["f", " ", " ", " ", " ", "f", " ", " ", " ", " ", "f", " ", " ", " ", "f", " ", " ", " ", " ", "f"],
    ["f", " ", " ", " ", " ", "f", " ", " ", " ", " ", "f", " ", " ", " ", "f", " ", " ", " ", " ", "f"],
    ["f", " ", " ", " ", " ", "f", " ", " ", " ", " ", "f", " ", " ", " ", "f", " ", " ", " ", " ", "f"],
    ["f", " ", " ", " ", " ", "f", " ", " ", " ", " ", "f", " ", " ", " ", "f", " ", " ", " ", " ", "f"],
    ["f", " ", " ", " ", " ", "f", " ", " ", " ", " ", "f", " ", " ", " ", "f", " ", " ", " ", " ", "f"],
    ["f", " ", " ", " ", " ", "f", " ", " ", " ", " ", "f", " ", " ", " ", "f", " ", " ", " ", " ", "f"],
    ["f", " ", " ", " ", " ", "f", " ", " ", " ", " ", " ", " ", " ", " ", "f", " ", " ", " ", " ", "f"],
    ["f", " ", " ", " ", " ", "f", " ", " ", " ", " ", " ", " ", " ", " ", "f", " ", " ", " ", " ", "f"],
    ["f", " ", " ", " ", " ", "f", " ", " ", " ", " ", " ", " ", " ", " ", "f", " ", " ", " ", " ", "f"],
    ["f", " ", " ", " ", " ", "f", " ", " ", " ", " ", " ", " ", " ", " ", "f", " ", " ", " ", " ", "f"],
    ["f", " ", " ", " ", " ", "f", " ", " ", " ", " ", " ", " ", " ", " ", "f", " ", " ", " ", " ", "f"],
    ["f", "f", "f", "f", "f", "f", "f", "f", "f", "f", "f", "f", "f", "f", "f", "e", "e", "e", "e", "f"]
  ],
  "entrance": [[0, 0], [0, 0]],
  "exit": [[14, 19], [5, 1]],
  "wind direction": "no wind here",
  "no brakes": false
}