{
  "map": [
    ["f", "f", "f", "f", "f", "f", "f", "f", "f", "f", "f", "f", "f", "f", "f", "f", "f", "f", "f", "f"],
    ["f", " ", " ", " ", " ", " ", " ", " ", " ", " ", " ", "f", "f", " ", " ", " ", " ", " ", " ", "f"],
    ["f", "f", " ", " ", " ", " ", " ", " ", " ", " ", " ", " ", "f", "f", " ", " ", " ", " ", " ", "f"],
    ["f", "f", "f", " ", " ", " ", " ", " ", " ", " ", " ", " ", " ", "f", " ", " ", " ", " ", " ", "f"],
    ["f", " ", "f", "f", " ", " ", " ", " ", " ", " ", " ", " ", " ", " ", " ", " ", " ", " ", " ", "f"],
    ["f", " ", " ", "f", "f", " ", " ", " ", " ", "f", "f", " ", " ", " ", " ", " ", "f", " ", " ", "f"],
    ["f", " ", " ", " ", "f", "f", " ", " ", " ", " ", "f", "f", " ", " ", " ", " ", "f", " ", " ", "f"],
    ["f", " ", " ", " ", " ", "f", "f", " ", " ", " ", " ", "f", "f", " ", " ", " ", "f", " ", " ", "f"],
    ["f", " ", " ", " ", " ", " ", "f", "f", " ", " ", " ", " ", "f", "f", " ", " ", "f", " ", " ", "f"],
    ["f", " ", " ", " ", " ", " ", " ", "f", "f", " ", " ", " ", " ", "f", "f", " ", "f", " ", " ", "f"],
    ["f", " ", " ", " ", " ", " ", " ", " ", "f", "f", " ", " ", " ", " ", "f", "f", "f", " ", " ", "f"],
    ["f", " ", " ", " ", " ", " ", " ", " ", " ", "f", "f", " ", " ", " ", " ", "f", "f", " ", " ", "f"],
    ["f", " ", " ", " ", " ", "f", " ", " ", " ", " ", "f", "f", " ", " ", " ", " ", "f", " ", " ", "f"],
    ["f", " ", " ", " ", " ", "f", "f", " ", " ", " ", " ", "f", "f", " ", " ", " ", "f", " ", " ", "f"],
    ["f", " ", " ", " ", " ", " ", "f", "f", " ", " ", " ", " ", "f", " ", " ", " ", "f", " ", " ", "f"],
    ["f", " ", " ", " ", " ", " ", " ", "f", "f", " ", " ", " ", " ", " ", " ", " ", "f", " ", " ", "f"],
    ["f", " ", " ", " ", " ", " ", " ", " ", "f", "f", " ", " ", " ", " ", " ", " ", "f", " ", " ", "f"],
    ["f", " ", " ", " ", " ", " ", " ", " ", " ", "f", "f", " ", " ", " ", " ", " ", "f", " ", " ", "f"],
    ["f", " ", " ", " ", " ", " ", " ", " ", " ", " ", "f", "f", " ", " ", " ", " ", "f", " ", " ", "f"],
    ["f", "f", "f", "e", "e", "e", "e", "f", "f", "f", "f", "f", "f", "f", "f", "f", "f", "E", "E", "f"]
  ],
  "entrance": [[17, 19], [2, 1]],
  "exit": [[3, 19], [4, 1]],
  "wind direction": "still no wind",
  "no brakes": false
}