{
  "map": [
    ["f", "f", "f", "f", "f", "f", "f", "f", "f", "f", "f", "f", "f", "f", "E", "E", "E", "E", "E", "f"],
    ["f", "f", "f", "f", "f", "f", "f", "f", "f", "f", "f", "f", "f", " ", " ", " ", " ", " ", " ", "f"],
    ["f", "f", "f", "f", "f", "f", "f", "f", "f", "f", "f", "f", " ", " ", " ", " ", " ", " ", " ", "f"],
    ["f", "f", "f", "f", "f", "f", "f", "f", "f", "f", "f", " ", " ", " ", " ", " ", " ", " ", " ", "f"],
    ["f", "f", "f", "f", "f", "f", "f", "f", "f", " ", " ", " ", " ", " ", " ", " ", " ", " ", " ", "f"],
    ["f", "f", "f", "f", "f", "f", "f", "f", "f", " ", " ", " ", " ", " ", " ", " ", " ", " ", " ", "f"],
    ["f", "f", "f", "f", "f", "f", "f", "f", " ", " ", " ", " ", " ", " ", " ", " ", " ", " ", "f", "f"],
    ["f", "f", "f", "f", "f", "f", "f", " ", " ", " ", " ", " ", " ", " ", " ", " ", " ", "f", "f", "f"],
    ["f", "f", "f", "f", "f", "f", " ", " ", " ", " ", " ", " ", " ", " ", " ", " ", "f", "f", "f", "f"],
    ["f", "f", "f", "f", " ", " ", " ", " ", " ", " ", " ", " ", " ", " ", " ", " ", "f", "f", "f", "f"],
    ["f", "f", "f", "f", " ", " ", " ", " ", " ", " ", " ", " ", " ", " ", "f", "f", "f", "f", "f", "f"],
    ["f", "f", "f", " ", " ", " ", " ", " ", " ", " ", " ", " ", " ", "f", "f", "f", "f", "f", "f", "f"],
    ["f", "f", " ", " ", " ", " ", " ", " ", " ", " ", " ", " ", "f", "f", "f", "f", "f", "f", "f", "f"],
    ["f", " ", " ", " ", " ", " ", " ", " ", " ", " ", " ", "f", "f", "f", "f", "f", "f", "f", "f", "f"],
    ["f", " ", " ", " ", " ", " ", " ", " ", " ", " ", "f", "f", "f", "f", "f", "f", "f", "f", "f", "f"],
    ["e", " ", " ", " ", " ", " ", " ", " ", " ", "f", "f", "f", "f", "f", "f", "f", "f", "f", "f", "f"],
    ["e", " ", " ", " ", " ", " ", " ", " ", " ", "f", "f", "f", "f", "f", "f", "f", "f", "f", "f", "f"],
    ["e", " ", " ", " ", " ", " ", " ", "f", "f", "f", "f", "f", "f", "f", "f", "f", "f", "f", "f", "f"],
    ["e", " ", " ", " ", " ", " ", "f", "f", "f", "f", "f", "f", "f", "f", "f", "f", "f", "f", "f", "f"],
    ["f", "f", "f", "f", "f", "f", "f", "f", "f", "f", "f", "f", "f", "f", "f", "f", "f", "f", "f", "f"]
  ],
  "entrance": [[14, 0], [5, 1]],
  "exit": [[0, 15], [1, 4]],
  "wind direction": "nor here",
  "no brakes": false,
  "checkpoint": [480, 45],

  "decorations": {
    "armour1": {
      "image-path": "assets/images/armour-holder.png",
      "can-die": true,
      "rotation": 0,
      "rect": [270, 120, 80, 70],
      "hit_rect": [270, 120, 80, 70]
    },

    "armour2": {
      "image-path": "assets/images/armour-holder.png",
      "can-die": true,
      "rotation": 0,
      "rect": [120, 270, 80, 70],
      "hit_rect": [120, 270, 80, 70]
    },

    "armour3": {
      "image-path": "assets/images/armour-holder.png",
      "can-die": true,
      "rotation": -90,
      "rect": [410, 220, 70, 80],
      "hit_rect": [410, 220, 70, 80]
    },

    "armour4": {
      "image-path": "assets/images/armour-holder.png",
      "can-die": true,
      "rotation": -90,
      "rect": [200, 430, 70, 80],
      "hit_rect": [200, 430, 70, 80]
    }
  }
}