{
  "map": [
    ["f", "f", "f", "f", "f", "f", "f", "f", "f", "f", "f", "f", "f", "f", "f", "f", "f", "f", "f", "f"],
    ["f", " ", " ", " ", " ", " ", " ", " ", " ", " ", " ", " ", " ", " ", " ", " ", " ", " ", " ", "f"],
    ["f", " ", " ", " ", " ", " ", " ", " ", " ", " ", " ", " ", " ", " ", " ", " ", " ", " ", " ", "f"],
    ["f", " ", " ", " ", " ", " ", " ", " ", " ", " ", " ", " ", " ", " ", " ", " ", " ", " ", " ", "f"],
    ["f", " ", " ", " ", " ", " ", " ", " ", " ", " ", " ", " ", " ", " ", " ", " ", " ", " ", " ", "f"],
    ["f", " ", " ", " ", " ", " ", " ", " ", " ", " ", " ", " ", " ", " ", " ", " ", " ", " ", " ", "f"],
    ["f", " ", " ", " ", " ", " ", " ", " ", " ", " ", " ", " ", " ", " ", " ", " ", " ", " ", " ", "f"],
    ["f", " ", " ", " ", " ", " ", " ", " ", " ", " ", " ", " ", " ", " ", " ", " ", " ", " ", " ", "f"],
    ["f", " ", " ", " ", " ", " ", " ", "f", "f", "f", "f", "f", "f", "f", " ", " ", " ", " ", " ", "f"],
    ["f", " ", " ", " ", " ", " ", " ", "f", "f", "f", "f", "f", "f", "f", " ", " ", " ", " ", " ", "f"],
    ["f", " ", " ", " ", " ", " ", " ", "f", "f", "f", "f", "f", "f", "f", " ", " ", " ", " ", " ", "f"],
    ["f", " ", " ", " ", " ", " ", " ", "f", "f", "f", "f", "f", "f", "f", " ", " ", " ", " ", " ", "f"],
    ["f", " ", " ", " ", " ", " ", " ", "f", "f", "f", "f", "f", "f", "f", " ", " ", " ", " ", " ", "f"],
    ["f", " ", " ", " ", " ", " ", " ", "f", "f", "f", "f", "f", "f", "f", " ", " ", " ", " ", " ", "f"],
    ["f", " ", " ", " ", " ", " ", " ", "f", "f", "f", "f", "f", "f", "f", " ", " ", " ", " ", " ", "f"],
    ["f", " ", " ", " ", " ", " ", " ", "f", "f", "f", "f", "f", "f", "f", " ", " ", " ", " ", " ", "f"],
    ["f", " ", " ", " ", " ", " ", " ", "f", "f", "f", "f", "f", "f", "f", " ", " ", " ", " ", " ", "f"],
    ["f", " ", " ", " ", " ", " ", " ", "f", "f", "f", "f", "f", "f", "f", " ", " ", " ", " ", " ", "f"],
    ["f", " ", " ", " ", " ", " ", " ", "f", "f", "f", "f", "f", "f", "f", " ", " ", " ", " ", " ", "f"],
    ["f", "f", "f", "f", "f", "f", "f", "f", "f", "f", "f", "f", "f", "f", "e", "e", "e", "e", "e", "f"]
  ],

  "entrance": [[0, 0], [0, 0]],
  "exit": [[14, 19], [5, 1]],

  "wind direction": "no wind here",
  "no brakes": false,
  "checkpoint": [105, 510],

  "decorations": {
    "tutorial1": {
      "image-path": "assets/images/tutorial1.png",
      "can-die": false,
      "rotation": 0,
      "rect": [260, 270, 120, 192],
      "hit-rect": [0, 0, 0, 0]
    },

    "tutorial2": {
      "image-path": "assets/images/tutorial2.png",
      "can-die": false,
      "rotation": 0,
      "rect": [260, 490, 120, 72],
      "hit_rect": [0, 0, 0, 0]
    },

    "armour1": {
      "image-path": "assets/images/armour-holder.png",
      "can-die": true,
      "rotation": 0,
      "rect": [60, 30, 80, 70],
      "hit_rect": [60, 30, 80, 70]
    },

    "armour2": {
      "image-path": "assets/images/armour-holder.png",
      "can-die": true,
      "rotation": 0,
      "rect": [480, 30, 80, 70],
      "hit_rect": [480, 30, 80, 70]
    },

    "armour3": {
      "image-path": "assets/images/armour-holder.png",
      "can-die": true,
      "rotation": 0,
      "rect": [270, 30, 80, 70],
      "hit_rect": [270, 30, 80, 70]
    }
  }
}