{
  "map": [
    ["f", "f", "f", "f", "f", "f", "f", "E", "E", "E", "E", "f", "f", "f", "f", "f", "f", "f", "f", "f"],
    ["f", " ", " ", " ", " ", " ", " ", " ", " ", " ", " ", "f", " ", " ", " ", " ", " ", " ", " ", "f"],
    ["f", " ", " ", " ", " ", " ", " ", " ", " ", " ", " ", "f", " ", " ", " ", " ", " ", " ", " ", "f"],
    ["f", " ", " ", " ", " ", " ", " ", " ", " ", " ", " ", "f", " ", " ", " ", " ", " ", " ", " ", "f"],
    ["f", " ", " ", " ", " ", " ", " ", " ", " ", " ", " ", "f", " ", " ", " ", "f", " ", " ", " ", "f"],
    ["f", " ", " ", " ", " ", "f", "f", "f", "f", "f", "f", "f", " ", " ", " ", "f", " ", " ", " ", "f"],
    ["f", " ", " ", " ", " ", " ", " ", " ", " ", " ", " ", " ", " ", " ", " ", "f", " ", " ", " ", "f"],
    ["f", " ", " ", " ", " ", " ", " ", " ", " ", " ", " ", " ", " ", " ", " ", "f", " ", " ", " ", "f"],
    ["f", " ", " ", " ", " ", " ", " ", " ", " ", " ", " ", " ", " ", " ", " ", "f", " ", " ", " ", "f"],
    ["f", " ", " ", " ", " ", " ", " ", " ", " ", " ", " ", " ", " ", " ", " ", "f", " ", " ", " ", "f"],
    ["f", "f", "f", "f", "f", "f", "f", "f", "f", "f", "f", "f", "f", "f", "f", "f", " ", " ", " ", "f"],
    ["f", " ", " ", " ", " ", " ", " ", " ", " ", " ", " ", " ", " ", " ", " ", " ", " ", " ", " ", "f"],
    ["f", " ", " ", " ", " ", " ", " ", " ", " ", " ", " ", " ", " ", " ", " ", " ", " ", " ", " ", "f"],
    ["f", " ", " ", " ", " ", " ", " ", " ", " ", " ", " ", " ", " ", " ", " ", " ", " ", " ", " ", "f"],
    ["f", " ", " ", " ", " ", " ", " ", " ", " ", " ", " ", " ", " ", " ", " ", " ", " ", " ", " ", "f"],
    ["f", " ", " ", " ", "f", "f", "f", "f", "f", "f", "f", "f", "f", "f", "f", "f", "f", "f", "f", "f"],
    ["f", " ", " ", " ", " ", " ", " ", " ", " ", " ", " ", " ", " ", " ", " ", " ", " ", " ", " ", "f"],
    ["f", " ", " ", " ", " ", " ", " ", " ", " ", " ", " ", " ", " ", " ", " ", " ", " ", " ", " ", "f"],
    ["f", " ", " ", " ", " ", " ", " ", " ", " ", " ", " ", " ", " ", " ", " ", " ", " ", " ", " ", "f"],
    ["f", "f", "f", "f", "f", "f", "f", "f", "e", "e", "e", "e", "f", "f", "f", "f", "f", "f", "f", "f"]
  ],
  "entrance": [[7, 0], [4, 1]],
  "exit": [[8, 19], [4, 1]],
  "wind direction": "why",
  "no brakes": false,
  "checkpoint": [285, 45],

  "decorations": {
    "armour1": {
      "image-path": "assets/images/armour-holder.png",
      "can-die": true,
      "rotation": 90,
      "rect": [30, 30, 70, 80],
      "hit_rect": [30, 30, 70, 80]
    },

    "armour2": {
      "image-path": "assets/images/armour-holder.png",
      "can-die": true,
      "rotation": 90,
      "rect": [30, 220, 70, 80],
      "hit_rect": [30, 220, 70, 80]
    },

    "armour3": {
      "image-path": "assets/images/armour-holder.png",
      "can-die": true,
      "rotation": -90,
      "rect": [500, 480, 70, 80],
      "hit_rect": [500, 480, 70, 80]
    }
  }
}