{
  "map": [
    ["f", "f", "f", "f", "f", "f", "f", "f", "E", "E", "E", "E", "f", "f", "f", "f", "f", "f", "f", "f"],
    ["f", " ", " ", " ", " ", " ", " ", "f", " ", " ", " ", " ", " ", " ", " ", " ", " ", " ", " ", "f"],
    ["f", " ", " ", " ", " ", " ", " ", "f", " ", " ", " ", " ", " ", " ", " ", " ", " ", " ", " ", "f"],
    ["f", " ", " ", " ", " ", " ", " ", "f", " ", " ", " ", " ", " ", " ", " ", " ", " ", " ", " ", "f"],
    ["e", " ", " ", " ", " ", " ", " ", "f", " ", " ", " ", " ", " ", " ", " ", " ", " ", " ", " ", "f"],
    ["e", " ", " ", " ", " ", " ", " ", "f", "f", "f", "f", "f", "f", "f", "f", " ", " ", " ", " ", "f"],
    ["e", " ", " ", " ", " ", " ", " ", " ", " ", " ", " ", " ", " ", " ", " ", " ", " ", " ", " ", "f"],
    ["e", " ", " ", " ", " ", " ", " ", " ", " ", " ", " ", " ", " ", " ", " ", " ", " ", " ", " ", "f"],
    ["f", " ", " ", " ", " ", " ", " ", " ", " ", " ", " ", " ", " ", " ", " ", " ", " ", " ", " ", "f"],
    ["f", " ", " ", " ", " ", " ", " ", " ", " ", " ", " ", " ", " ", " ", " ", " ", " ", " ", " ", "f"],
    ["f", "f", "f", "f", "f", "f", "f", "f", "f", "f", "f", "f", "f", "f", "f", "f", "f", "f", "f", "f"],
    ["f", " ", " ", " ", "f", " ", " ", " ", " ", " ", " ", " ", " ", " ", " ", " ", " ", " ", " ", "f"],
    ["f", " ", " ", " ", "f", " ", " ", " ", " ", " ", " ", " ", " ", " ", " ", " ", " ", " ", " ", "f"],
    ["E", " ", " ", " ", "f", " ", " ", " ", " ", " ", " ", " ", " ", " ", " ", " ", " ", " ", " ", "e"],
    ["E", " ", " ", " ", "f", " ", " ", " ", " ", " ", " ", " ", "f", " ", " ", " ", " ", " ", " ", "e"],
    ["E", " ", " ", " ", "f", " ", " ", " ", " ", " ", " ", " ", "f", " ", " ", " ", " ", " ", " ", "e"],
    ["E", " ", " ", " ", " ", " ", " ", " ", " ", " ", " ", " ", "f", " ", " ", " ", " ", " ", " ", "e"],
    ["f", " ", " ", " ", " ", " ", " ", " ", " ", " ", " ", " ", "f", " ", " ", " ", " ", " ", " ", "f"],
    ["f", " ", " ", " ", " ", " ", " ", " ", " ", " ", " ", " ", "f", " ", " ", " ", " ", " ", " ", "f"],
    ["f", "f", "f", "f", "f", "f", "f", "f", "f", "f", "f", "f", "f", "f", "f", "f", "f", "f", "f", "f"]
  ],
  "entrance": [[8, 0], [4, 1]],
  "exit": [[0, 4], [1, 4]],
  "wind direction": "no",
  "no brakes": true,
  "checkpoint": [285, 45],

  "decorations": {
    "armour1": {
      "image-path": "assets/images/armour-holder.png",
      "can-die": true,
      "rotation": 90,
      "rect": [30, 30, 70, 80],
      "hit_rect": [30, 30, 70, 80]
    }
  }
}