{
  "map":  [
    ["f", "f", "f", "f", "f", "f", "f", "f", "f", "f", "f", "f", "f", "f", "f", "f", "f", "f", "f", "f"],
    ["f", " ", " ", " ", " ", " ", " ", " ", " ", " ", " ", " ", " ", " ", " ", " ", " ", " ", " ", "f"],
    ["f", " ", " ", " ", " ", " ", " ", " ", " ", " ", " ", " ", " ", " ", " ", " ", " ", " ", " ", "f"],
    ["f", " ", " ", " ", " ", " ", " ", " ", " ", " ", " ", " ", " ", " ", " ", " ", " ", " ", " ", "f"],
    ["f", " ", " ", " ", " ", " ", " ", " ", " ", " ", " ", " ", " ", " ", " ", " ", " ", " ", " ", "f"],
    ["f", " ", " ", " ", " ", "f", "f", "f", "f", "f", "f", "f", "f", "f", "f", " ", " ", " ", " ", "f"],
    ["f", " ", " ", " ", " ", " ", " ", " ", " ", " ", " ", " ", " ", " ", "f", " ", " ", " ", " ", "f"],
    ["f", " ", " ", " ", " ", " ", " ", " ", " ", " ", " ", " ", " ", " ", "f", " ", " ", " ", " ", "f"],
    ["f", " ", " ", " ", " ", " ", " ", " ", " ", " ", " ", " ", " ", " ", "f", " ", " ", " ", " ", "f"],
    ["f", " ", " ", " ", " ", " ", " ", " ", " ", " ", " ", " ", " ", " ", "f", " ", " ", " ", " ", "f"],
    ["f", " ", " ", " ", " ", " ", " ", " ", " ", " ", " ", " ", " ", " ", "f", " ", " ", " ", " ", "f"],
    ["f", " ", " ", " ", " ", " ", " ", " ", " ", " ", " ", " ", " ", " ", "f", " ", " ", " ", " ", "f"],
    ["f", "f", "f", "f", "f", "f", "f", "f", "f", "f", "f", " ", " ", " ", "f", " ", " ", " ", " ", "f"],
    ["E", " ", " ", " ", " ", " ", " ", " ", " ", " ", " ", " ", " ", " ", "f", " ", " ", " ", " ", "f"],
    ["E", " ", " ", " ", " ", " ", " ", " ", " ", " ", " ", " ", " ", " ", "f", " ", " ", " ", " ", "f"],
    ["E", " ", " ", " ", " ", " ", " ", " ", " ", " ", " ", " ", " ", " ", "f", " ", " ", " ", " ", "f"],
    ["E", " ", " ", " ", " ", " ", " ", " ", " ", " ", " ", " ", " ", " ", "f", " ", " ", " ", " ", "f"],
    ["f", " ", " ", " ", " ", " ", " ", " ", " ", " ", " ", " ", " ", " ", "f", " ", " ", " ", " ", "f"],
    ["f", " ", " ", " ", " ", " ", " ", " ", " ", " ", " ", " ", " ", " ", "f", " ", " ", " ", " ", "f"],
    ["f", "f", "f", "f", "f", "f", "f", "f", "f", "f", "f", "f", "f", "f", "f", "e", "e", "e", "e", "f"]
  ],
  "entrance": [[0, 13], [1, 4]],
  "exit": [[15, 19], [4, 1]],
  "wind direction": "left",
  "no brakes": true,
  "checkpoint": [45, 435],

  "decorations": {
    "armour1": {
      "image-path": "assets/images/armour-holder.png",
      "can-die": true,
      "rotation": 180,
      "rect": [30, 500, 80, 70],
      "hit_rect": [30, 500, 80, 70]
    },

    "armour2": {
      "image-path": "assets/images/armour-holder.png",
      "can-die": true,
      "rotation": 180,
      "rect": [133, 500, 80, 70],
      "hit_rect": [133, 500, 80, 70]
    },

    "armour3": {
      "image-path": "assets/images/armour-holder.png",
      "can-die": true,
      "rotation": 180,
      "rect": [236, 500, 80, 70],
      "hit_rect": [236, 500, 80, 70]
    },

    "armour4": {
      "image-path": "assets/images/armour-holder.png",
      "can-die": true,
      "rotation": 180,
      "rect": [340, 500, 80, 70],
      "hit_rect": [340, 500, 80, 70]
    }
  }
}