{
  "map": [
    ["f", "E", "E", "E", "E", "f", "f", "f", "f", "f", "f", "f", "f", "f", "f", "e", "e", "e", "e", "f"],
    ["f", " ", " ", " ", " ", "f", "f", "f", "f", "f", "f", "f", "f", "f", "f", " ", " ", " ", " ", "f"],
    ["f", " ", " ", " ", " ", "f", "f", "f", "f", "f", "f", "f", "f", "f", "f", " ", " ", " ", " ", "f"],
    ["f", " ", " ", " ", " ", "f", "f", "f", "f", "f", "f", "f", "f", "f", "f", " ", " ", " ", " ", "f"],
    ["f", " ", " ", " ", " ", "f", "f", "f", "f", "f", "f", "f", "f", "f", "f", " ", " ", " ", " ", "f"],
    ["f", " ", " ", " ", " ", "f", "f", "f", "f", "f", "f", "f", "f", "f", "f", " ", " ", " ", " ", "f"],
    ["f", " ", " ", " ", " ", " ", "f", "f", "f", "f", "f", "f", "f", "f", " ", " ", " ", " ", " ", "f"],
    ["f", " ", " ", " ", " ", " ", "f", "f", "f", "f", "f", "f", "f", "f", " ", " ", " ", " ", " ", "f"],
    ["f", " ", " ", " ", " ", " ", "f", "f", "f", "f", "f", "f", "f", "f", " ", " ", " ", " ", " ", "f"],
    ["f", " ", " ", " ", " ", " ", " ", "f", "f", "f", "f", "f", "f", " ", " ", " ", " ", " ", " ", "f"],
    ["f", " ", " ", " ", " ", " ", " ", "f", "f", "f", "f", "f", "f", " ", " ", " ", " ", " ", " ", "f"],
    ["f", " ", " ", " ", " ", " ", " ", " ", "f", "f", "f", "f", " ", " ", " ", " ", " ", " ", " ", "f"],
    ["f", " ", " ", " ", " ", " ", " ", " ", " ", " ", " ", " ", " ", " ", " ", " ", " ", " ", " ", "f"],
    ["f", " ", " ", " ", " ", " ", " ", " ", " ", " ", " ", " ", " ", " ", " ", " ", " ", " ", " ", "f"],
    ["f", " ", " ", " ", " ", " ", " ", " ", " ", " ", " ", " ", " ", " ", " ", " ", " ", " ", " ", "f"],
    ["f", " ", " ", " ", " ", " ", " ", " ", " ", " ", " ", " ", " ", " ", " ", " ", " ", " ", " ", "f"],
    ["f", "f", " ", " ", " ", " ", " ", " ", " ", " ", " ", " ", " ", " ", " ", " ", " ", " ", "f", "f"],
    ["f", "f", " ", " ", " ", " ", " ", " ", " ", " ", " ", " ", " ", " ", " ", " ", " ", " ", "f", "f"],
    ["f", "f", "f", "f", " ", " ", " ", " ", " ", " ", " ", " ", " ", " ", " ", " ", "f", "f", "f", "f"],
    ["f", "f", "f", "f", "f", "f", "f", "f", "f", "f", "f", "f", "f", "f", "f", "f", "f", "f", "f", "f"]
  ],
  "entrance": [[1, 0], [4, 1]],
  "exit": [[15, 0], [4, 1]],
  "wind direction": "up",
  "no brakes": true,
  "checkpoint": [75, 45],

  "decorations": {}
}